




***************  *************************************************************
*                                                                            *
*                   **                                                       *
*         ****                  ***                                          *
*     ****              *****                                                *
***                                     *    ***      *******************    *
*   ***  @                       ***                 *                       *
*      ***         *                                *                        *
*            ***                                   *                         *
*        **         ***      *           **********                          *
*                      * * * *                                               *
******************************************************************************