****************
*              *
*              *
*         **** *
*     ****     *
***            *
*   ***        *
*      ***     *
*            ***
*        **    *
*              *
****************